    PARADIGMA ORIENTADO A OBJETOS: REPRESENTAR LA REALIDAD EN CODIGO, SE VISUALIZA AQUELLO QUE QUIERO REPRESENTAR COMO CLASES, Y LAS INSTANCIAS
DE ESA CLASE SON SUS OBJETOS.

    PILARES: 
        ABSTRACCIÓN: (MODELADO DE UNA PORCIÓN DE LA REALIDAD TOMANDO SOLO LOS CONCEPTOS GENERALES DE AQUELLO QUE QUEREMOS REPRESENTAR).
        ENCAPSULACION: OCULTAR INFORMACIÓN DE MANERA QUE PODAMOS PREVEER LOS CAMBIOS Y QUE AFECTE SOLO A AQUELLO QUE ENCAPSULAMOS, DE 
    MANERA QUE EL RESTO DEL PROGRAMA FUNCIONE DE IGUAL MANERA (CAMBIAR SIN QUE NADA CAMBIE).
        HERENCIA: MECANISMO POR EL CUAL DERIVAMOS AQUELLO QUE ES ESENCIAL DE UNA CLASE GENERAL, DE MANERA QUE PUEDA USARSE EN CLASES MAS CONCRETAS
        POLIFORMISMO: MECANISMO POR EL CUAL UN MISMO METODO PUEDE SER DEFINIDO CON UN COMPORTAMIENTO DIFERENTE.

    
    OBJETO: INSTANCIA CONCRETA DE UNA CLASE, TIENE METODOS Y ATRIBUTOS DEFINIDOS.
    CLASE: MODELO GENERAL QUE DEFINE UN CONJUNTO DE ATRIBUTOS Y METODOS QUE DESCRIBEN UNA ENTIDAD.
    INSTANCIA: OBJETO CREADO A PARTIR DE UNA CLASE.


    MODIFICADOR DE ACCESO: PALABRA RESERVADA QUE DEFINE COMO SE VAN A VISUALIZAR LOS ATRIBUTOS Y METODOS DE UNA CLASE.
    PRIVATE: SOLO CONOCIDA POR LA MISMA CLASE.
    PUBLIC: CONOCIDA POR CUALQUIER PORCIÓN DEL PROGRAMA.
    PROTECTED: SOLO CONOCIDO POR LA MISMA CLASE Y SUS DERIVADOS (CLASES HIJAS).

    VARIABLE: IDENTIFICADOR QUE REPRESENTA UN ESPACIO EN MEMORIA.

    VARIABLE LOCAL VS GLOBAL: LA DIFERENCIA ES EL ALCANCE(SCOPE), EN LA LOCAL SOLO ES VISIBLE EN LA PORCIÓN DE CODIGO DONDE FUE DEFINIDA.
NO PUEDE SER ACCEDIDA DESDE AFUERA. VARIABLE GLOBAL ES CONOCIDA POR TODO EL PROGRAMA.

    PARAMETRO: VARIABLE QUE SE PASA EN UN METODO.

    BUENAS PRACTICAS:
    1) VARIABLE COMIENZA CON MINUSCULA. SI SON 2 PALABRAS, CAMELCASE.
    2) NOMBRES CARACTERISTICOS, QUE REPRESENTEN A LA VARIABLE.
    3) NOMBRES SIN PALABRAS RESERVADAS

    JAVA VIRTUAL MACHINE: INTERMEDIARIO ENTRE NUESTRO PROGRAMA Y EL S.O.

    METODO STATIC: SE PUEDE INVOCAR SIN CREAR UNA INSTANCIA DE CLASE. 
    VARIABLE STATIC: VALOR COMPARTIDO POR TODAS LAS INSTANCIAS DE UNA CLASE.
    CONSTANTE (FINAL): VARIABLE INMODIFICABLE.
    METODO FINAL: NO PUEDE SOBRESCRIBIRSE.
    CLASE FINAL: NO SE PUEDE APLICAR HERENCIA.

    HERENCIA CONLLEVA A UNA ESTRUCTURA DE ARBOLES.
    
    



